Euro | â‚¬
Cent | Â¢
Accent a | Ã¡
Accent e | Ã©
Accent i | Ã­
Accent o | Ã³
Accent u | Ãº
Accent u 2| Ã¼
Accent n | Ã±
Upside Down Question Mark | Â¿
Infility | âˆ
Approximately Equal | â‰ˆ
Not Equal | â‰ 
Less Than or Equal to | â‰¤
Greater Than or Equal to | â‰¥
Plus or Minus | Â±
Multiply | Ã—
Divide | Ã·
Pi | Ï€
Alpha | Î±
Beta | Î²
Gamma | Î³
Delta | Î”
Theta | Î¸
Kappa | Îº
Lamda | Î»
Mu | Î¼
Keyboard | âŒ¨
Benzene | âŒ¬
Square | â¯€
Check | âœ“
x | âœ—
Cross | âœ—
Left | â†
Up | â†‘
Down | â†“
Right | â†’
sqrt | âˆš
Half | Â½
Third | â…“
Two Thirds | â…”
Angle | âˆ 
Degree | Â°
Bitcoin | â‚¿
Note | â™ª

Tears of Joy | ğŸ˜‚
Heart | â¤ï¸
ROFL | ğŸ¤£
Nervous | ğŸ˜…
Cool | ğŸ˜
Sparkles | âœ¨
Skull | ğŸ’€
Poop | ğŸ’©
o | x
